944akk94ji-j444akkkk
200844600--00008444a
200000000--000000003
200000000g-000000003
20000000000000000003
2000h--0000000h--003
20000000000000000003
20000000000000000003
21111111tttt11111113
20000000000000000003