2000000tt00000000001
20000000000000000001
20000000000000000001
20000003300000000001
200000000000000000e-
200000000000000000--
200000000220000000--
11115000000000071111
1kkk150000000071kkk1
11111111111111111111