94444444444444444444
20000000000000000000
20000000000000000000
20000000000000000000
d-000000000000000000
--000000000000000000
--000000000000000000
20000000000000000000
20000000000000000000
b1111111111111111111







