91111111111111111119
20000000000000000003
20000000000000000003
20000000000000000003
200000000000000000e0
20000000000000000000
20000000001111111000
20000000000000008119
20000000000000000003
20011100000000000003