91111111111111111119
20000000000000000003
20000000000000000003
20000000000000000003
200000000000000000e-
200000000000000000--
200000000011111111--
20000000000000000019
20000000000000000003
20011100000000000003