94444444444444444449
20000000000000000003
20000000000000000003
200000000000000000e0
20000000000000000000
2000000000@000000000
20000000001111111111
20000000000000008449
20000000000000000003
20011100000000000003