9444444444kk4444444a
20000000003200000003
20000000003200000003
200000000032000000e0
20000000003200000000
20000000003200000000
2000111111c2!0000011
20000000003b1nppo14k
2000000000300200300k
k111111000300200300k