94444444444444444444
2rrrrrrrrrrrrrrrrrrr
20000000000000000000
d0000000000000000000
00000000000000000000
00000000g-0000g-0000
10000000000000000000
k1110000000000000000
2qqqqqqqqqqqqqqqqqqq
b1111111111111111111