20000000000000000003
200h--00000000000003
20000000000000000003
200000000000000000e0
2000000000g-00000000
20000000000000000000
20@0000000000000!001
k11111tttt111111111k
k000000000000000000k
k000000000000000000k