4444444444444444444a
00000000000000000003
00000000000000000003
00000000000000000003
00000000000000000003
00000000000000000003
00000000000000000003
00000000000000000003
!0000000000000000003
1111111111111111111c