11111111111111111111
00000000000000000001
00000000000000000001
11111111100000000001
000000001000000000e-
000000001000000000--
111111111000000000--
00000000000000001111
00000000000000001kkk
11111111111111111kkk
