4444444444444444444a
00000000000000000003
0000!000000000000003
11111111n00000000003
000000002000000000e0
00000000200000000000
44444444m00000000000
00000000000000001111
00000000000000001kkk
11111111111111111kkk
