11111111pppp11111111
10000000000000000001
10000000000000000001
10000000444000000004
10000000000000000001
10000000000000000001
20003330000000000001
10000000000000000001
10000000000000000001
20000000000043200001
