94444444pppp4444444a
20000000000000000003
20000000000000000003
20000000h--000000003
20000000000000000003
20000000000000000003
2000h--0000000000003
20000000000000@00003
20000000000000000003
200000000000h--00003
