20000000000000000003
20000000000000000003
2000h--0000000000003
d0000000000000000003
00000000h--0000000e0
00000000000000000000
20000000000000000000
b1111111111111111111
kkkkkkkkkkkkkkkkkkkk
kkkkkkkkkkkkkkkkkkkk