9444444444444444444a
20000000000000000003
20000000000000000003
200000000000000000e-
200000000000000000--
200000000000000000--
20000f00000jj1111111
2000000000000844akkk
200000000000000084ak
20f000000f000000008k
20000000000000000003
20000000000000000003
2000g-0000000000003
20000000000000000003
20000000000000000003
20000000000h--000003
20000000000000000003
20000000000000000003
200h--00000000000003
20000000000000000003
20000000000000000003
2000000f000000000003
20000000000000f00003
20000000000000000003
d-0000000g-000000003
--000000000000000003
--000000000000000003
b111111111111111111c
kkkkkkkkkkkkkkkkkkkk
kkkkkkkkkkkkkkkkkkkk