10000000000000000003
10000000000000000001
30001220000000000001
10000000000000000001
d-0000003330000000e-
--0000000000000000--
--0000000000000000--
11111111111111111111
kkkkkkkkkkkkkkkkkkkk
kkkkkkkkkkkkkkkkkkkk