20000000000000000003
20000000000000000003
2000h--0000000000003
d-000000000000000003
--000000h--0000000e-
--0000000000000000--
200000000000000000--
b1111111111111111111
kkkkkkkkkkkkkkkkkkkk
kkkkkkkkkkkkkkkkkkkk