94444444a94444444444444444444444444444444444444444444444444a
20000000pp0000000rrrr0000000000rrr000000000000000rrrr0000003
20000000pp00000000000000000000000000000000000000000000000003
20000000pp00000000000000000000000000000000000000000000000003
2000000032000000000000000000000000000000000000000000000000e-
2000000032000000000000000000000000000000000000000000000000--
20000000320000000000000000000000e0000000000000000000000000--
20000000320000o11n0000h--0000000000000h--0000000000000o11111
20000000320000300200000000000000000000000000000e0000003kkkkk
b111111132ppppc002qqqqqqqqqqqqqqqqqqqqqqqqqqqqqqqqqqqqckkkkk
