11111111111111111111
10000000000001000000
10000000000001000000
d-000000000001000000
--00000000000p000000
--00000000000p000000
11111111111111pppppp
10000000000001000000
10000000000001000000
11111111111111111111


