9444444444444k444441
2000000000000k000000
2000000000000k000000
d000000000000k000000
0000000000000p000000
0000000000000p000000
kkkkkkkkkkkkkkpppppp
k000000000000k000000
k000000000000k000000
k111111111111k111111


