11111111111111111111
00000010000000000001
00000010000000000001
000000100000000000e-
000000100000000000--
000000100000000000--
pppppp111111111pp111
00000010000000000001
00000010000000000001
11111111111111111111