444444k444444444444a
000000k0000000000003
000000k0000000000003
000000k00000000000e0
000000k0000000000000
000000k0000000000000
ppppppk11111111pp11k
000000p0000000000003
000000p0000000000003
111111k111111111111c