9444444444444444444a
20000000000000000003
20000000000000000003
d-000000000000000003
--000000000000000003
--000000000000000003
jjjjjjjjj00000000003
20000000000000000003
20000000000000000003
2000000jjjjjjjjjjjjj
20000000000000000003
20000000000000000003
jjjjjjjjjjjj00000003
20000000000000000003
20000000000000000003
200000jjjjjjjjjjjjjj
20000000000000000003
20000000000000000003
jjjjjjjjjjjjjjj00003
20000000000000000003
20000000000000000003
20f000000g-000000f03
20000000000000000003
d-0000f000000f0000e-
--0000000000000000--
--0000000000000000--
11111111pppp11111111
kkkkkkkk0000kkkkkkkk
kkkkkkkk0000kkkkkkkk
kkkkkkkkkkkkkkkkkkkk

