94444444444u444444444444444444444444444a
2000000000000200000000000pp0000000000003
2000000000000200000000000pp0000000000003
20000000000f0200000000000pp0000000000003
20h--00000000200000000000pp00000000000e-
2000000000000200000000000pp00000000000--
20000000h--00200000000000pp00000000000--
2000000000000111111111111111111111pp1111
2000000000000000000000000000000000000p03
b111pppp1111111111111111111111111111111c