94k4444444444444444a
20k00000000000000003
20k00000000000000003
20k000000000000000e0
20p000000@0000000000
20p00000000000000000
20p0000011111111111k
20k00000000000000003
20k00000000000000003
20kg-000000000000003