20000000000000000003
20000000000000000003
20000000000000000003
d-0000000000000000e-
--0000000000000000--
--0000000000000000--
tppppppppppppppppppt
20000000000000000003
20000000000000000003
20000000000000000003