20000000000000000003
20000000000000000003
20000000000000000003
d00000000000000000e0
00000000000000000000
00000000000000000000
tppppppppppppppppppt
20000000000000000003
20000000000000000003
20000000000000000003