20000000000000000003
20000000000000000003
20000000000000000003
d0000000000000000003
00000000000000000003
000000@0000000000?03
tppppppppppppppppppt
20000000000000000003
20000000000000000003
20000000000000000003