10100000000000000001
10100110000000000001
10100000000000000001
10100000000000000001
10100000000011000001
10100000000000000001
10100000000000000001
10100442100000000001
10100000000000000001
10100000000000000001