20k00000000000000003
20k00g-0000000000003
20k00000000000000003
20k00000000000000003
20k000000000g-000003
20k00000000000000003
20k00000000000000003
20k00h--000000000003
20k00000000000000003
20k00000000000000003