20k000000000h--00003
20k00000000000000003
20k00000000000000003
20k000h--000000000e0
20p00000000000000000
20p00000000000000000
b111111111111111111k
kkkkkkkkkkkkkkkkkkkk
kkkkkkkkkkkkkkkkkkkk
kkkkkkkkkkkkkkkkkkkk