10100000000011300001
10100000000000000001
10100000000000000001
101000111100000000e-
10p000000000000000--
10p000000000000000--
11111111111111111111
kkkkkkkkkkkkkkkkkkkk
kkkkkkkkkkkkkkkkkkkk
kkkkkkkkkkkkkkkkkkkk