11111111111111111111
10000000000000001111
10000000000000001111
d-00000000000000pppp
--00000000000000pppp
--0000000000000011pp
111111111111111111pp
10000000000000000000
10000000000000000000
11111111111111111111







