k9444444444444akkkkk
k20000000000008akkkk
4m00000000000008akkk
pp000000000000008444
pp000000000000000000
on000000000000000000
lb111111111111111111
00000000000!00000000
00000000000000000000
11111111111111111111











