11111111111111111111
11000000000000811111
11000000000000081111
pp000000000000008111
pp000000000000000000
11000000000000000000
11111111111111111111
00000000000000000000
00000000000000000000
11111111111111111111











