9444444444444444444a
20000000000000000003
20000000000000000003
u0000000000000000003
200000000000000000e-
200000000000000000--
200000000000000000--
2000h--000000011111a
20000000000000000003
20000000000000000003
2000000000f000000003
20000000000000000003
20000000000000000003
200g-000000000000003
20000000000000000003
20000000000000000003
20000000f000000f0003
20000000000000000003
20000000000000000003
200f000000f00000h--3
20000000000000000003
20000000000000000003
20000000g-0000000003
20000000000000000003
2000f00000000f000003
20000000000000000003
2000000000000000e003
200000e0000000000003
20000000000000000003
20000000000000000003
200000000000h--00003
20000000000000000003
20000000000000000003
20000f0000f000000003
20000000000000000003
20000000000000000003
200f000000000f000003
2000000f000000000003
20000000000000000003
20000000000000000003
20000000f00000h--003
20000000000000000003
20000000000000000003
t000g-00000h--000003
t0000000000000000003
t0000000000000000003
b1111111111pppp1111c
20000000000000000003
20000000000000000003
211pppp1111111111113
20000000000000000003
20000000000000000003
200h--00000000000003
20000000000000000003
20000000000000000003
2000000000f000000003
2000000000000000e003
2000f000000000000003
20000000000000f00003
2000000f000000000003
20000000000000000003
20000000000h--000g-3
20g-0000000000000003
200000000f0000000003
20000000000000000003
2000000f0000f0000003
20000000000000000003
200000000f000000f003
20000000000000000003
20000000000000000003
20000f00000000f00003
200000000g-000000003
20000000000000000003
20000000000000000003
200h--0000000h--0003
20000000000000000003
20000000000000000003
20000g-0000000000003
20000000000000000003
20000000000000000003
200000000000h--00003
20000000000000000003
20000000000000000003
200000f0000000000003
20000000000000000003
20000000000000g-0003
20000000000000000003
20000000f00000000003
20000000000000000003
20000000000000f00003
2000f000000000000003
20000000000000000003
2000000h--0000000003
20000000000000000003
200000000000000f0003
200f0000000000000003
20000000000000000003
20000000g-0000000003
20000000000000000003
20000000000000000003
20000000000000f00003
2000f000000000000003
20000000000000000003
20000000000000000003
d-0000000g-0000000e-
--0000000000000000--
--0000000000000000--
111111111pp111111111
kkkkkkkkk00kkkkkkkkk
kkkkkkkkkkkkkkkkkkkk