11111111111111111111
11111170000000000001
11111700000000000001
11117000000000000001
p00000000000000000e-
p00000000000000000--
111111111115000000--
00000p00001111111111
00000p00001000000001
111111pppp1111111111