1000000tt00000000001
10000000000000000001
10000000000000000001
10000003300000000001
d-0000000000000000e-
--0000000000000000--
--0000000220000000--
11115000000000071111
1kkk150000000071kkk1
11111111111111111111