2000000tt00000000003
20000000000000000003
20000000000000000003
2000000g-00000000003
d-0000000000000000e-
--0000000000000000--
--0000000g-0000000--
k111500000000007111k
kkkkb5000000007ckkkk
kkkkkkkkkkkkkkkkkkkk