944444444444444444444444444444444444444a
2rrrrrrrrrrrrrrrrrrrrrrrrrrrrrrrrrrrrrr3
2000000000000000000000000000000000000003
2000000000000000000000000000000000000003
d-000000000000000000000000000000000000e-
--000000g-0000g-000000g-000000g-000000--
--000000000000000000000000000000000000--
1111000000000000000000000000000000001111
2qqqqqqqqqqqqqqqqqqqqqqqqqqqqqqqqqqqqqq3
b11111111111111111111111111111111111111c