2000000tt00000000003
20000000000000000003
2000000@000000000003
2000000g-00000000003
d00000000000000000e0
00000000000000000000
000000000g-000000000
k111500000000007111k
kkkkb500@@00007ckkkk
kkkkkkkkkkkkkkkkkkkk