944k4444444444444444
200p0000000000000000
200p0000000000000000
kkkkkkkkkk0000kkkkkk
d00000000k0000000000
000000000k0000000000
0000007ppkkkkkkk0000
k11111c0000000000000
k0000000000000000000
k1111111111111111111

















