11111111111111111111
100p0000000000000000
100p0000000000000000
11111111110000111111
d-000000010000000000
--000000010000000000
--00005pp11111110000
11111110000000000000
10000000000000000000
11111111111111111111

















