11111111111111111111
000000011000p0000001
000000011000p0000001
1111pp11101110000001
10000001100010000001
10000001100010000001
11pp1111111010000001
10000000p00010000001
10000000p00011111111
111111111ppppp111111













