jjjjjjjjjjjjjjjjjjjj
j00rr00000000000000j
j00--00000000000000j
j00--0000000000000e-
j00--0000000000000--
j00--0000000000000--
j00--0000jjjjjjjjjjj
j00--00000000000000j
j00--00000000000000j
j00--00000000000000j
j00--000000000--000j
j00--000000000--000j
j00--000000000--000j
j00--000000000--000j
j00--000000000--000j
j00--000000000--000j
j00x-000000000--000j
jjjjjjj0000000--000j
jjjjj000000000--000j
jjj00000000000--000j
j0000000000000--000j
j00--000000000--000j
j00--000000000--000j
j00--000000000--000j
j00--000000000x-000j
j00--0000000jjjjjjjj
j00--000000000jjjjjj
j00--00000000000jjjj
j00--0000000000000jj
j00--00000000000000j
j00--00000000000000j
j00--00000000--0000j
j00--00000000--0000j
j00--00000000--0000j
j00--00000000--0000j
j00--00000000--0000j
j00x-00000000--0000j
jpjjjjjj00000--0000j
jujjjj0000000--0000j
jjjj000000000--0000j
j000000000000--0000j
j000000000000--0000j
j000000000000--0000j
d-00000000000--0000j
--00000000000--0000j
--00000000000--0000j
j000000000000--0000j
j000000000000--0000j
j000000000000x-0000j
jjjjjjjjjjjjjjjjjjjj
