11111111111111111111
00000000000000000001
00000000000000000001
000000000000000000e-
000000000000000000--
000000000000000000--
00000000000000000001
00000000000000000001
00000000000000000001
11111111111111111111
