4444444444444444444a
00000000000000000003
00000000000000000003
000000000000000000e0
00000000000000000000
00000000000000000000
00000000000000000003
00000000000000000003
00000000@0@000000003
1111111111111111111c
