94444444444444444444
20000000000000000000
20000000000000000000
20000000000000000000
d0000000000000000000
00000000000000000000
00000000000000000000
k1115000000000000000
kkkkb500000!00000000
kkkkkb11111111111111









