11111111111111111111
10000000000000000000
10000000000000000000
10000000000000000000
d-000000000000000000
--000000000000000000
--000000000000000000
11115000000000000000
kkkk1500000000000000
kkkkk111111111111111









