9444444mppppl444444a
20000000000000000003
20000000000000000003
20000000h--000000003
2000000000000000003
20000000000000000003
200000000000000g-003
20000h--000000000003
20000000000000000003
20000000000000000003
2000000000000h--0003
20000000000000000003
20000000000000000003
200000h--00000000003
20000000000000000003
20000000000000000003
d-0000000000h--00003
--000000000000000003
--000000000000000003
1111111111111111111b