44444444444444444444
00000000000000000000
00000000000000000000
00000000000000000000
00000000000000000000
00000000000000000000
000000kkkkkkk0000000
00000000000000000000
00000000000000000000
11111111111111111111