44444444444444444444
00000000000000000000
00000000000000000000
00000000000000000000
00000000000000000000
00000000000000000000
00000000000000000000
00000000!00000000000
00000000000000000000
11111111111111111111