11111111111111111111
00000000000000000001
00000000000000000001
000000000000000000d-
000000000000000000--
000000000000000000--
00000611111111111111
00061kkkkkkkkkkkkkkk
00061kkkkkkkkkkkkkkk
11111kkkkkkkkkkkkkkk











