4444444444444444444a
00000000000000000003
00000000000000000003
000000000000000000e-
000000000000000000--
000000000000000000--
0000071111111111111k
00071ckkkkkkkkkkkkkk
0003kkkkkkkkkkkkkkkk
111ckkkkkkkkkkkkkkkk











