11111111111111111111
10000000000000000001
10000000000000000001
100000000000000000e-
100000000000000000--
100000000000000000--
10000000001111111111
10000000000000000001
10000000000000000001
10011100000000000001