20000000000000000003
20000000000000000003
2000000000h--0000003
20000000000000000003
20000000000000000003
200h--00000000000003
20000000000!00000003
20000000000000000003
20000000000h--000003
20000000000000000003