10000000000000000001
10000000000000000001
10000000001111000001
10000000000000000001
10000000000000000001
10013200000000000001
10000000000000000001
10000000000000000001
10000000000123000001
10000000000000000001