10000000000000000001
10013200000000000001
10000000000000000001
10000000000000000001
100000000011000000e-
100000000000000000--
100000000000000000--
111111tttt1111111111
10000000000000000001
10000000000000000001