20000000000000000003
200h--00000000000003
20000000000000000003
20000000000000000003
2000000000g-000000e0
2000!000000000000000
20000000000000000000
k11111tttt111111111k
k000000000000000000k
k000000000000000000k