20000000000000000003
20000000000000000003
20000000000000000003
20000000000000000003
20000000000000000003
20000000000000000003
200@000000000000!003
20000000000000000003
k111110000111111111k
20000200003000000003