20000300003000000003
20000300003000000003
k4444m0000l44444444k
d-000000000000000003
--000000000000000003
--000000000000000003
k111111111111111111c
kkkkkkkkkkkkkkkkkkkk
kkkkkkkkkkkkkkkkkkkk
kkkkkkkkkkkkkkkkkkkk