10000100001000000001
10000100000000000001
11111100001111111111
d-000000000000000001
--000000000000000001
--000000000000000001
11111111111111111111
kkkkkkkkkkkkkkkkkkkk
kkkkkkkkkkkkkkkkkkkk
kkkkkkkkkkkkkkkkkkkk