94444444tttt4444444a
20000000000000000003
20000000000000000003
20000000000000000003
20000000000000000003
20000000000000000003
20000000000000000003
20000000tttt00000003
20000000000000000003
20000000000000000003
20000000000000000003
20000000000000000003
20000000000000000003
20000000000000000003
200000000000000000e-
200000000000000000--
200000000000000000--
20000000tttt00111111
2000000e000000000003
2e000000000000000003
20000000000000000003
200h--00000000000003
20000000000000000003
20000000000000000003
d-000000tttt00000003
--000000000000000003
--000000000000000003
11111111111111ppppp3
20000000000000000003
20000000000000000003
20000000000000000003
20000000000000000003
20000000000000000003
200000000000000000e-
200000000000000000--
200000000000000000--
20000000000000000003
20000000000000000003
20000000000000000003
b111111111111111111c