kkkkkkkk94444444444a
kkkkkkk9600000000003
44444446000000000003
d-0000000000000000e-
--0000000000000000--
--0000000000000000--
k111160000000000111k
kkk96000000000000003
kk9600000g-000000003
kk200000000000000003