20000000000000000003
20000000000000000003
20000000000000000003
d00000000tt000000003
00000000000000000003
00000@00000000000003
11111111000000000003
200000000tt000000003
20000000000000000003
20000000000000000003