20000000000000000003
20000000000000000003
20000000000000000003
d-0000000tt000000003
--000000000000000003
--000000000000000003
11111111000000000003
200000000tt000000003
20000000000000000003
20000000000000000003