11111111111111111111
10000000001100000001
10000000001100000001
10000000001100000001
100000000011000000e-
100000000011000000--
100011111111000000--
10000000001111pp1111
10000000001001001001
11111110001001001001