944444444444444444444444444444444444444a
2000000000000000000000000000000000000003
2000000000000000000000000000000000000003
d-000000000000000000000000000000000000e-
--000000000000000000000000000000000000--
--000000000000000000000000000000000000--
2000000000000000000000000000000000000003
2000000000000000000000000000000000000003
2000000000000000000000000000000000000003
b11111111111111111111111111111111111111c