9444444444kk4444444a
20000000003200000003
20000000003200000003
20000000003200000003
200000000032000000e0
20000000003200000000
2000111111c200000000
20000000003b1nppo11k
200000000030020030!k
k1111110003002003!0k