10000010001001001001
10000010001001001001
11111111111111pp1001
10000000000001001001
10000000000001001001
10001111111111001001
10000000000001001001
10000000000001001001
11111111100001001001
10000000000001001001