200000k000k002003003
200000k000k002003003
2kkkkkkkkkkkk2pp3003
20000000000002003003
20000000000002003003
20001111111112003003
200000!0000002003003
20000000000002003003
k1111111100002003003
20000000000002003003