944akk94ji-j444akkkk
200844600--00008444a
200000000--000000003
200000000g-000000003
20000000000000000003
2000h--0000000h--003
20000000000000000003
20000000000000000003
21111111tttt11111113
20000000000000000003
20000000000000000003
20000000000000000003
20000000000000000003
d-0000000000000000e-
--0000000000000000--
--0000000000000000--
tttttttttttttttttttt
20000000000000000003
20000000000000000003
20000000000000000003
20000000000000000003
20000000000000000003
20000000000000000003
20000000000000000003
20000000000000000003
20000000000000000003
20000000000000000003
20000000000000000003
20000000000000000003
20000000000000000003
20000000000000000003
20000000000000000003
20000000000000000003
20000000000000000003
20000000000000000003
20000000000000000003
20000000000000000003
20000000000000000003
20000000000000000003
20000000000000000003
20000000000000000003
20000000000000000003
20000000000000000003
d-0000000tt000000003
--000000000000000003
--000000000000000003
11111111000000000003
200000000tt000000003
20000000000000000003
20000000000000000003
2000h--0000000h--003
20000000000000000003
20000000000000000003
200000000tt000000003
20000000000000000003
20000000000000000003
20g-0000000000g-0003
20000000000000000003
20000000000000000003
200000000tt000000003
20000000000000000003
20000000000000000003
2000h--00000000g-003
20000000000000000003
20000000000000000003
200000000tt000000003
20000000000000000003
20000000000000000003
200g-000000000g-0003
20000000000000000003
20000000000000000003
200000000tt000000003
20000000000000000003
d-0000f0000000f000e-
--0000000000000000--
--0000000000000000--
11111111100111111111
00000000011000000000
00000000000000000000
00000000000000000000