10000000000001001001
1111111pp11111001001
10000000000001pp1111
d-000000000000000001
--000001100000000001
--000000000000000001
11111111111111111111
10000000000000000001
10000000000000000001
11111111111111111111