20000000000002003003
kkkkkkkppkkkk2003003
200000000000lmppl44k
d-000000000000000003
--00000kk00000000003
--000000000000000003
k111111111111111111c
20000000000000000003
20000000000000000003
k1111111111111111111