94444444444444444444
20000000000000000000
20000000000000000000
d0000000000000000000
00000000000000000000
00000000000000000000
20000000000000000000
2000000000!00!@00000
20000000000000000000
b1111111111111111111







