9444444444444444444a
2000000000pp00000003
2000000000pp00000003
2000000000pp000000e0
2000000000on00000000
20000!00003200000000
2000111111k200000003
20000000003k11tt111k
20000000003002003003
k11111n0003002003003