11111111pppp11111111
10000000000000000001
10000000000000000001
10000000444000000004
10000000000000000001
10000000000000000001
20003330000000000001
10000000000000000001
10000000000000000001
20000000000043200001
10000000000000000003
10000000000000000001
30001220000000000001
10000000000000000001
d-0000003330000000e-
--0000000000000000--
--0000000000000000--
11111111111111111111
kkkkkkkkkkkkkkkkkkkk
kkkkkkkkkkkkkkkkkkkk