11111111111111111111
1000000000pp00000001
1000000000pp00000001
1000000000pp00000001
100000000011000000e-
100000000011000000--
100011111111000000--
10000000001111tt1111
10000000001001001001
11111110001001001001