20000020003002003003
20000020003002003003
k11111mpppl112tt3003
200000000@0002003003
20000000000002003003
20001111111112003003
20000000000002003003
20000000000002003003
k1111111100002003003
20000000000002003003