20000000000002003003
k111111pp11112003003
200000000000lmttktt3
d-000000000000000003
--000001100000000003
--000000000000000003
k111111111111111111k
20000000000000000003
20000000000000000003
k111111111111111111k