1111111111111111111111111111111111111111
1000000000000100000000000010000000000001
1000000000000100000000000010000000000001
d-000000000001000000000000100000000000e-
--00000000000p000000000000100000000000--
--00000000000p000000000000100000000000--
11111111111111pppppppppppp111111111pp111
1000000000000100000000000010000000000001
1000000000000100000000000010000000000001
1111111111111111111111111111111111111111