11111111111111111111
10100000000000000001
10100000000000000001
10100000000000000001
10p000000000000000e-
10p000000000000000--
10p000000000000000--
10100000011111111111
10100000100000000001
10111000000000000001
10100000000000000001
10100110000000000001
10100000000000000001
10100000000000000001
10100000000011000001
10100000000000000001
10100000000000000001
10100442100000000001
10100000000000000001
10100000000000000001
10100000000011300001
10100000000000000001
10100000000000000001
101000111100000000e-
10p000000000000000--
10p000000000000000--
11111111111111111111
kkkkkkkkkkkkkkkkkkkk
kkkkkkkkkkkkkkkkkkkk
kkkkkkkkkkkkkkkkkkkk