2000h--0000000h--003
20000000000000000003
20000000000000000003
200000000tt000000003
200@00000000000!0003
20000000000000000003
20g-0000000000g-0003
20000000000000000003
20000000000000000003
200000000tt000000003