111111111111111111111111111111111111111111111111111111111111
100000000000000011111100000000000081111111111170000000000001
100000000000000011111100000000000008111111111700000000000001
d-00000000000000pppppp00000000000000811111117000000000000001
--00000000000000pppppp000000000000000000p00000000000000000e-
--0000000000000011pp11000000000000000000p00000000000000000--
111111111111111111pp11111111111111111111111111111115000000--
100000000000000000000000000000000000000000000p00001111111111
100000000000000000000000000000000000000000000p00001000000001
1111111111111111111111111111111111111111111111pppp1111111111