9444444444444444444a
20000000000000000003
20000000000000000003
200000000000000000e0
20000000000000000000
20000000000000000000
2000000000000111111k
20000000000000000003
20000000000000000003
20000000000000000003