111111pppp1111111111
10000000000000000001
10000000000000000001
10000000000000000001
10000000000000000001
10000000000000000001
10000000000000000001
10000000000000000001
10000000000000000001
10000000000000000001
1000000tt00000000001
10000000000000000001
10000000000000000001
10000003300000000001
d-0000000000000000e-
--0000000000000000--
--000000022000000--
11115000000000061111
1kkk150000000061kkk1
11111111111111111111