11111111111111111111
10000000000000000001
10000000000000000001
100000000000000000e-
100000000000000000--
100000000000000000--
10000000001111111111
10000000000000000001
10000000000000000001
10011100000000000001
10000000000000000001
10000000000000000001
10000000001111000001
10000000000000000001
10000000000000000001
10013200000000000001
10000000000000000001
10000000000000000001
10000000000123000001
10000000000000000001
10000000000000000001
10013200000000000001
10000000000000000001
10000000000000000001
100000000011000000e-
100000000000000000--
100000000000000000--
111111tttt1111111111
10000000000000000001
10000000000000000001
10000000000000000001
10000000000000000001
10000000000000000001
10000000000000000001
10000000000000000001
10000000000000000001
10000000000000000001
10000000000000000001
11111100001111111111
10000100001000000001
10000100001000000001
10000100000000000001
11111100001111111111
d-000000000000000001
--000000000000000001
--000000000000000001
11111111111111111111
kkkkkkkkkkkkkkkkkkkk
kkkkkkkkkkkkkkkkkkkk
kkkkkkkkkkkkkkkkkkkk