20000000000000000003
20000000000000000003
20000000000000000003
20000000000000000003
d0000000000000000003
00000000000000000003
00000000000000000003
k111111111111111111k
20000000000000000003
b111111111111111111c