kkkkkkkk94444444444a
kkkkkkk9600000000003
11111116000000000003
d-0000000000000000e-
--0000000000000000--
--0000000000000000--
11111600000000001111
kkk96000000000000003
kk9600000g-000000003
kk200000000000000003
k960000000000000007c
96000e000000h--0003k
2000000000000000003k
200000000000000007ck
d-00000h--00000003kk
--000000000000007ckk
--000000000000003kkk
1111111111111111ckkk
kkkkkkkkkkkkkkkkkkkk
kkkkkkkkkkkkkkkkkkkk