20000000000000000003
20000000000000000003
2000h--00000000g-003
20000000000000000003
20000000000000000003
200000000tt000000003
20000000000000@00003
20000000000000000003
200g-000000000g-0003
20000000000000000003