11111111111111111111
10000000001100000001
10000000001100000001
10000000001100000001
100000000011000000e-
100000000011000000--
100011111111000000--
10000000001111pp1111
10000000001001001001
11111110001001001001
10000010001001001001
10000010001001001001
11111111111111pp1001
10000000000001001001
10000000000001001001
10001111111111001001
10000000000001001001
10000000000001001001
11111111100001001001
10000000000001001001
10000000000001001001
1111111pp11111001001
10000000000001pp1111
d-000000000000000001
--000001100000000001
--000000000000000001
11111111111111111111
10000000000000000001
10000000000000000001
11111111111111111111