20000000000000000003
20000000000000000003
20000000000000000003
20000000000000000003
200000000000000000e-
200000000000000000--
200000000000000000--
k111111111111111111k
20000000000000000003
b111111111111111111c