9444444444444444444a
20000000000000000003
20000000000000000003
d-000000000000000003
--000000000000000003
--000000000000000003
jjjjjjjjj00000000003
20000000000000000003
20000000000000000003
2000000jjjjjjjjjjjjj