9444444444444444444a
20000000000000000003
20000000000000000003
d-000000000000000003
--000000000000000003
--000000000000000003
k1111111100000000003
20000000000000000003
20000000000000000003
2000000111111111111k