9444444444444444444a
20000000000000000003
20000000000000000003
d0000000000000000003
00000000000000000003
0000000@000000000003
k1111111100000000003
20000000000000000003
20000000000000000003
2000000111111111111k