20000000000000000003
20f000000g-000000f03
20000000000000000003
200000f000000f000003
200000000000000000e-
200000000000000000--
200000000000000000--
11111111pppp11111111
kkkkkkkk0000kkkkkkkk
kkkkkkkkkkkkkkkkkkkk

