20000000000000000003
200000000tt000000003
20000000000000000003
d00000f0000000f00003
00000000000000000003
0000?000000000000?03
k111111110011111111k
00000000k11k00000000
00000000000000000000
00000000000000000000