20000000000000000003
200000000tt000000003
20000000000000000003
d-0000f0000000f000e-
--0000000000000000--
--0000000000000000--
11111111100111111111
00000000011000000000
00000000000000000000
00000000000000000000