a444444444444444444a
20000000000000000003
2000000000000000003c
200000000000000003ck
d-0000000000000f03ak
--00000000000000003a
--000000000000000003
2h--0000000000f00003
2000000000000000003c
20000000000f0000003k
2000000000000000003a
b200f000000000000003
k2000000f00000000003
k2000000000000000003
920000000000000000e-
2000000000f0000000--
200000000000000000--
b1111111111111111111
kkkkkkkkkkkkkkkkkkkk
kkkkkkkkkkkkkkkkkkkk
