11111111111111111111
10000000000000000001
10000000000000000001
100000000000000000e-
100000000000000000--
100000000000000000--
10000000000001111111
10000000000000000001
10000000000000000001
10000000000000000001
10000000000000000001
10000000000000000001
10000000000000000001
10000000000000000001
100000000000000000e-
100000000000000000--
100000000000000000--
11111111111111111111
10000000000000000001
11111111111111111111