k960000000000000007c
96000e000000h--0003k
2000000000000000003k
200000000000000007ck
d-00000h--00000003kk
--000000000000007ckk
--000000000000003kkk
1111111111111111ckkk
kkkkkkkkkkkkkkkkkkkk
kkkkkkkkkkkkkkkkkkkk