k960000000000000007c
960000000000h--0003k
2000000000000000003k
200000000000000007ck
d000000h--00000003kk
00000000000000007ckk
00000000!00000003kkk
k111111111111111ckkk
kkkkkkkkkkkkkkkkkkkk
kkkkkkkkkkkkkkkkkkkk