944444444i-44444444a
200000000--000000003
200000000--000000003
d00000000--000000003
00000000000000000003
00000000000000000003
k1115000000000000003
kkkkk500000000000003
kkkkkk1111111111111c
kkkkkkkkkkkkkkkkkkkk