111111111i-111111111
100000000--000000001
100000000--000000001
d-0000000--000000001
--000000000000000001
--000000000000000001
11115000000000000001
kkkkk500000000000001
kkkkkk11111111111111
kkkkkkkkkkkkkkkkkkkk