20000000000000000003
2h--0000000000000003
20000000000000000003
200000000g-000000003
20000000000000000003
2000@00000000000!003
k111111tttt11111111k
20000000000000000003
20000000000000000003
k111111pppp11111111k