20000000000000000000
200000000000g-000000
20000000000000000000
20000000000000000000
2000g-00000000000000
20000000000000000000
20000000000000000000
20000000000000000000
20000000n00000000000
20000001911111111111