99444444444444444444
96000000000000000000
20000000000000000000
20000000000000000000
20000000000000000000
20000000000000000111
20000000000000000000
20000000000000000000
20000000000000000000
20000000000000000000