00000000000000000003
0000000g-00000000003
00000000000000000003
00000000000000000003
00000000000000000003
000000000000g-000003
00000000000000000003
00000000000000000003
000000000000000o0079
11111111111111191199