9444444444444444444a
20000000000000000003
20000000000000000003
20000000000000000003
d0000000000000000003
00000000000000000003
00000000000000000003
20000000000000000003
20000000000000000003
b111111111111111111c