94444444444444444444
2rrrrrrrrrrrrrrrrrrr
20000000000000000000
20000000000000000000
d-000000000000000000
--000000g-0000g-0000
--000000000000000000
11110000000000000000
2qqqqqqqqqqqqqqqqqqq
b1111111111111111111