44444444444444444499
00000000000000000089
00000000000000000003
00000000000000000003
00000000000000000003
11100000000000000003
00000000000000000003
00000000000000000003
00000000000000000003
00000000000000000003