4444444444444444444a
rrrrrrrrrrrrrrrrrrr3
00000000000000000003
00000000000000000003
000000000000000000e0
00g-000000g-00000000
00000000000000000000
00000000000000001111
qqqqqqqqqqqqqqqqqqq3
1111111111111111111c