9444444444444444444c
20000000000000000003
20000000000000000003
20000000000000000003
d-000000000000000003
--000000000000000003
--000000000000000003
11111110000000000003
20000000000000000003
20000000000000000003
20000000000000000003
20000000000000000003
20000000000000000003
20000000000000000003
20000000000000000003
20000000000000000003
20000000000000000003
20000000000000000003
20000000000000000003
20000000000000000003
20000000000000000003
20000000000000000003
20000000000000000003
20000000000000000003
d-000000000000000003
--000000000000000003
--000000000000000003
1111111111111111111c
kkkkkkkkkkkkkkkkkkkk
kkkkkkkkkkkkkkkkkkkk