94444444444u44444444
20000000000002000000
20000000000002000000
20000000000f02000000
20h--000000002000000
20000000000002000000
20000000h--002111111
20000000000000000000
20000000000000000000
b111pppp111111111111