4444444444444444444a
00000pp0000000000003
00000pp0000000000003
00000pp0000000000003
00000pp00000000000e0
@0000pp0000000000000
1111111111111pp00000
00000000000000pp1111
00000000000000000p03
1111111111111111111c