9444444tttt44444444a
20000000000000000003
20000000000000000003
20000000000000000003
20000000000000000003
20000000000000000003
20000000000000000003
20000000000000000003
20000000000000000003
20000000000000000003
20000000000000000003
20000000000000000003
2jjjjjj0000jjjjjjjj3
200000000000000000e-
200000000000000000--
200000000000000000--
20000000000000001111
20000000000000000003
20000000000000000003
b111111111111111111c