944444444444444444444444444444444444444a
2000000000000000000000000000000000000003
2000000000000000000000000000000000000003
20000000000000000000000000000000000000e-
20000000000000000000000000000000000000--
20000000000000000000000000000000000000--
2000000000000000000000000000000000000003
2000000000000000000000000000000000000003
2000000000000000000000000000000000000003
b1111pppp111111111111111111111111111111c