kkkkkkkk94444444444a
kkkkkkk9600000000003
91111116000000000003
200000000000000000e0
d0000000000000000000
00000000000000000000
00071600000000001111
11196000000000000003
kk9600000g-000000003
kk200000000000000003