kkkkkkkk94444444444a
kkkkkkk9600000000003
94444446000000000003
20000000000000000003
d0000000000000000003
00000000000000000003
00071600000000001111
11196000000000000003
kk9600000g-000000003
kk200000000000000003