9444444444444444444a
20000000000000000003
20000000000000000003
200000000000000000e0
20000000000000000000
20000000000000000000
20000000000000000011
20000000000000000003
20000000000000000003
b111111111111111111c